11111111111111111111
10000000000000000001
10000001111100000001
10000010000100000001
1000001P0000000000C1
10000011110111000001
1000000E011100000001
10000111100E00000001
1000000C011100000001
11111111111111111111
