11111111111111111111111
1E00C0000000000C10000C1
10101101C01110111010011
10100100101010100010011
1P000001000000000100001
10000C010000000C01000C1
10100101001000010010011
10101100101011100010011
100010000C11C00000000E1
11111111111111111111111
