1111111111111111111111111111111111
1E00C0000000000C10000C0000000C00E1
10101101C0111011101001000010010101
1010010010101010001001000010010101
1P00000100000000010000000010000001
10000C010000000C01000C000100000C01
1010010100100001001001000100010101
1010110010101110001001000100010101
100010000C11C0000000000E00000000C1
1111111111111111111111111111111111
