11111111111111111111111
1EG0C00000G0000C10000C1
10101101C01110111010011
1010010G101G10100010G11
1P000001000000000100001
10G00C0100G0000C01000C1
10100101001000010010011
1010110G101G11100010G11
100010000C11C00000000C1
11111111111111111111111
