1111111111111111111111111111111111
1EG0C00000G0000C10000C0000G00C00E1
10101101C0111011101001000010010101
1010010G101G10100010G1000010G101G1
1P00000100000000010000000010000001
10G00C0100G0000C01000C0001000G0C01
1010010100100001001001000100010101
1010110G101G11100010G1000100010101
100010000C11C0000000000E000G000GC1
1111111111111111111111111111111111
