11111111111111111111
1E01E00E10000E0PE001
10010011001100000001
100C10C00C10C00C00C1
11111111111111111111
